000000000000
000001100000
001111111100
001111111100
000001100000
000000000000